1 1 1 1 1 1 1 1 1 1 1 1 1 1 1 1 1 1 1 1 1 1 1 1 1 1 1 1 1 1 1 1 1 1 1 1 1 1 1 1 1 1 1 1 1 1 1 1 1 1
1 1 1 1 1 1 1 1 1 1 1 1 1 1 1 1 1 1 1 1 1 1 1 1 1 1 1 1 1 1 1 1 1 1 1 1 1 1 1 1 1 1 1 1 1 1 1 1 1 1
1 1 1 1 1 1 1 1 1 1 1 1 1 1 1 1 1 1 1 1 1 1 1 1 1 1 1 1 1 1 1 1 1 1 1 1 1 1 1 1 1 1 1 1 1 1 1 1 1 1
1 1 1 1 1 1 1 1 1 1 1 1 1 1 1 1 1 1 1 1 1 1 1 1 1 1 1 1 1 1 1 1 1 1 1 1 1 1 1 1 1 1 1 1 1 1 1 1 1 1
1 1 1 1 1 1 1 1 1 1 1 1 1 1 1 1 1 1 1 1 1 1 1 1 1 1 1 1 1 1 1 1 1 1 1 1 1 1 1 1 1 1 1 1 1 1 1 1 1 1
1 1 1 1 1 1 1 1 1 1 1 1 1 1 1 1 1 1 1 1 1 1 1 1 1 1 1 1 1 1 1 1 1 1 1 1 1 1 1 1 1 1 1 1 1 1 1 1 1 1
1 1 1 1 1 1 1 1 1 1 1 1 1 1 1 1 1 1 1 1 1 1 1 1 1 1 1 1 1 1 1 1 1 1 1 1 1 1 1 1 1 1 1 1 1 1 1 1 1 1
1 1 1 2 2 2 2 2 2 2 2 2 3 4 4 4 4 4 3 1 1 3 4 4 4 4 4 4 3 1 1 1 3 4 4 4 4 4 4 1 5 5 1 1 1 1 1 1 1 1
1 2 2 2 2 2 2 2 8 4 4 4 4 1 1 1 1 1 4 4 4 3 1 1 1 1 1 1 4 4 4 4 4 0 0 0 0 0 3 4 4 3 1 1 1 1 1 1 1 1
1 2 2 2 2 2 2 2 9 0 0 0 1 0 0 0 0 0 1 0 0 0 0 5 0 3 4 4 3 0 0 0 5 1 0 1 0 0 0 1 0 3 1 1 1 1 1 1 1 1
1 2 2 2 2 2 2 2 8 0 0 0 1 0 0 1 0 0 1 1 1 0 0 0 0 3 0 0 1 0 1 0 1 0 0 0 0 1 0 0 0 3 1 1 1 1 1 1 1 1
1 2 2 2 2 2 2 2 8 1 1 1 1 1 1 5 0 0 0 0 0 0 1 0 0 3 0 1 1 5 0 0 1 0 1 0 0 0 0 5 1 3 1 1 1 1 1 1 1 1
1 2 2 2 2 2 2 2 8 1 0 0 1 0 5 0 1 3 4 4 4 4 4 4 4 4 4 4 3 0 0 1 5 0 0 0 1 0 1 1 0 3 1 1 1 1 1 1 1 1
1 2 2 2 2 2 2 2 8 0 1 0 1 0 5 0 1 3 0 0 1 0 0 0 1 0 0 1 3 1 1 0 5 0 5 0 1 1 5 1 0 3 1 1 1 1 1 1 1 1
1 2 2 2 2 2 2 2 8 0 1 0 0 1 0 1 0 3 0 5 1 0 1 1 0 0 0 0 3 0 0 0 0 0 1 0 4 4 4 4 4 3 1 1 1 1 1 1 1 1
1 2 2 2 2 2 2 2 8 0 0 0 0 0 0 0 5 3 0 5 1 0 0 0 1 0 1 1 3 1 1 0 1 1 1 1 3 1 1 0 1 0 1 1 1 1 1 1 1 1
1 1 1 2 2 2 2 2 8 0 5 1 1 1 0 0 1 3 0 1 1 1 1 0 3 4 4 4 3 5 5 1 1 0 0 0 3 0 5 1 1 1 1 1 1 1 1 1 1 1
1 1 1 2 2 2 2 2 8 0 0 1 0 0 0 1 1 3 1 2 2 2 2 1 3 1 1 1 1 0 1 0 1 0 1 0 3 4 4 1 1 5 1 1 1 1 1 1 1 1
1 1 1 2 2 2 2 2 8 0 0 1 1 0 0 0 1 3 2 2 2 2 2 2 3 0 0 1 0 0 1 0 0 5 1 0 0 0 3 0 1 1 1 1 1 1 1 1 1 1
1 1 2 2 2 2 2 2 9 8 8 8 0 5 1 0 1 3 2 2 2 2 2 2 3 5 0 1 0 1 1 0 1 0 1 0 1 0 3 0 1 0 1 1 1 1 1 1 1 1
1 2 2 2 2 2 2 2 2 2 2 8 0 0 0 0 0 3 5 2 2 2 2 5 3 0 0 0 0 1 0 0 0 1 0 0 5 0 3 0 1 0 1 1 1 1 1 1 1 1
1 2 2 2 2 2 2 2 2 2 2 8 4 4 4 4 4 4 4 4 4 4 4 4 4 4 4 4 4 4 4 4 4 4 4 4 4 4 4 4 4 3 1 1 1 1 1 1 1 1
1 2 2 2 2 2 2 2 2 2 2 8 1 1 1 1 0 0 1 1 1 1 0 0 3 5 5 6 6 6 6 6 3 0 5 0 0 1 1 5 0 3 1 1 1 1 1 1 1 1
1 2 2 2 2 2 2 2 2 2 2 8 0 0 1 0 0 5 0 1 1 1 1 0 3 0 0 0 0 0 6 6 3 0 0 1 0 0 0 0 0 3 1 1 1 1 1 1 1 1
1 2 2 2 2 2 2 2 2 8 8 8 0 1 1 0 1 0 0 0 0 0 0 0 3 5 5 6 6 0 0 6 3 1 0 1 0 1 1 1 0 3 1 1 1 1 1 1 1 1
1 2 2 2 2 2 2 2 2 8 0 0 1 0 0 1 0 1 1 1 0 1 5 0 3 5 5 6 6 6 0 6 3 0 0 0 0 0 0 5 0 3 1 1 1 1 1 1 1 1
1 2 2 2 2 2 2 2 2 8 0 1 1 0 1 0 0 0 0 0 0 0 0 0 3 5 5 6 6 6 6 6 3 4 4 3 0 1 0 0 0 3 1 1 1 1 1 1 1 1
1 2 2 2 2 2 2 2 2 8 1 0 1 0 1 0 1 1 1 1 1 1 0 0 3 5 5 1 1 1 1 1 1 0 0 3 0 1 1 5 0 3 1 1 1 1 1 1 1 1
1 2 2 2 2 2 2 2 8 8 0 3 4 4 4 4 4 4 4 4 4 4 4 4 4 0 0 1 1 0 5 1 0 0 1 3 0 0 1 0 0 3 1 1 1 1 1 1 1 1
1 2 2 2 2 2 2 2 9 8 1 3 0 1 0 0 0 1 0 0 1 1 1 0 3 1 0 0 1 3 4 4 4 4 4 4 4 4 4 4 4 3 1 1 1 1 1 1 1 1
1 2 2 2 2 2 2 2 8 8 0 3 0 0 0 1 1 1 1 0 0 0 0 0 3 4 4 4 4 3 1 0 0 1 0 0 1 1 1 1 5 3 1 1 1 1 1 1 1 1
1 2 2 2 2 2 2 2 8 0 0 3 1 1 0 0 1 0 1 0 1 5 0 1 0 0 0 0 1 3 0 0 5 1 1 0 0 0 1 4 4 3 1 1 1 1 1 1 1 1
1 2 2 2 2 2 2 2 8 0 1 3 0 0 1 1 1 1 0 0 0 0 0 1 1 0 1 0 1 3 1 1 0 1 1 1 0 1 1 3 1 1 1 1 1 1 1 1 1 1
1 2 2 2 2 2 2 2 8 4 4 4 1 1 1 0 1 0 0 1 0 1 1 1 0 1 1 0 1 3 1 0 1 1 5 1 0 1 1 3 1 1 1 1 1 1 1 1 1 1
1 2 2 2 2 2 2 2 8 1 0 1 0 0 0 0 1 0 5 0 0 1 0 5 0 0 1 0 5 3 0 0 0 0 1 0 0 1 0 3 0 5 1 1 1 1 1 1 1 1
1 2 2 2 2 2 2 2 8 5 0 1 0 1 0 1 5 0 1 1 1 1 0 1 1 0 1 0 5 3 0 1 0 1 1 1 0 0 0 3 0 0 1 1 1 1 1 1 1 1
1 2 2 2 2 2 2 2 8 1 1 1 0 0 1 0 0 0 1 0 0 1 0 0 0 0 1 1 0 3 1 1 0 1 1 1 1 1 0 3 1 0 1 1 1 1 1 1 1 1
1 2 2 2 2 2 2 2 8 1 0 4 4 4 4 4 4 4 4 4 4 4 4 3 4 4 4 4 4 4 1 1 0 0 1 1 1 5 0 3 0 0 1 1 1 1 1 1 1 1
1 2 2 2 2 2 2 2 8 1 0 3 0 0 1 0 0 1 0 1 0 0 1 3 1 1 0 0 0 1 1 1 1 1 1 1 1 0 0 3 4 4 1 1 1 1 1 1 1 1
1 2 2 2 2 2 2 2 8 5 1 3 1 1 1 1 0 1 5 0 1 1 0 3 0 0 1 0 1 0 0 0 0 0 5 0 0 1 1 0 5 3 1 1 1 1 1 1 1 1
1 2 2 2 2 2 2 2 8 1 1 3 0 0 0 1 0 1 0 0 1 0 0 3 4 4 4 4 4 4 4 4 4 3 0 0 1 0 0 0 1 3 1 1 1 1 1 1 1 1
1 2 2 2 2 2 2 2 8 1 1 4 3 0 1 0 0 1 3 4 4 4 4 3 0 5 0 0 1 1 1 1 1 3 1 1 1 1 1 1 1 3 1 1 1 1 1 1 1 1
1 2 2 2 2 2 2 2 8 1 5 1 3 1 1 1 1 1 3 1 1 1 1 0 1 0 1 0 0 0 0 0 5 3 1 1 1 1 1 1 1 3 1 1 1 1 1 1 1 1
1 2 2 2 2 2 2 2 8 4 4 4 4 4 4 4 4 4 3 5 0 0 1 0 5 0 1 1 1 1 1 0 5 4 4 4 4 4 4 4 4 3 1 1 1 1 1 1 1 1
1 1 1 1 1 1 1 1 1 1 1 1 1 1 1 1 1 1 1 1 1 0 0 0 1 0 0 0 0 0 0 0 1 1 1 1 1 1 1 1 1 1 1 1 1 1 1 1 1 1
1 1 1 1 1 1 1 1 1 1 1 1 1 1 1 1 1 1 1 1 1 1 1 1 1 1 1 1 1 1 1 1 1 1 1 1 1 1 1 1 1 1 1 1 1 1 1 1 1 1
1 1 1 1 1 1 1 1 1 1 1 1 1 1 1 1 1 1 1 1 1 1 1 1 1 1 1 1 1 1 1 1 1 1 1 1 1 1 1 1 1 1 1 1 1 1 1 1 1 1
1 1 1 1 1 1 1 1 1 1 1 1 1 1 1 1 1 1 1 1 1 1 1 1 1 1 1 1 1 1 1 1 1 1 1 1 1 1 1 1 1 1 1 1 1 1 1 1 1 1
1 1 1 1 1 1 1 1 1 1 1 1 1 1 1 1 1 1 1 1 1 1 1 1 1 1 1 1 1 1 1 1 1 1 1 1 1 1 1 1 1 1 1 1 1 1 1 1 1 1
1 1 1 1 1 1 1 1 1 1 1 1 1 1 1 1 1 1 1 1 1 1 1 1 1 1 1 1 1 1 1 1 1 1 1 1 1 1 1 1 1 1 1 1 1 1 1 1 1 1
